1111111111111111111111
10000000P00000K0000001
100C000C11111111111111
1111110000000000000E11
1111111111111111111111