1111111111111111111111
101100000P000C00000001
1111000111111111111111
1111110000C00000000E11
1111111111111111111111